NO ./texture/SquidGame/rose.xpm

SO ./texture/SquidGame/rose.xpm
WE ./texture/SquidGame/rose.xpm
EA ./texture/SquidGame/rose.xpm

F 240, 89, 132
C 0 , 255, 0

9999999999991
9LLLLLSLLLLL9
9HHHHHHHHHHH9
9111111110119
9AAAAAAAAAAA9
9OOOOOOOOOO!9
9111111110119
9AAAAAAAAAAA9
9OOOOOOOOOO!9
9111111110119
9AAAAAAAAAAA9
9OOOOOOOOOO!9
9111111110119
9AAAAAAAAAAA9
9OOOOOOOOOO!9
9111111110119
9AAAAAAAAAAA9
9OOO||||||||!9
1111111111111
