WE ./textures/Wall/brick.xpm
NO ./textures/Wall/Beton.xpm
SO ./textures/Wall/metal.xpm
EA ./textures/Wall/wood.xpm

F 255,100,0
C 225,255,255

        1111111111111111111111111
        1000000000110000000000001
        1011000001110000000000001
        1001000000000000000000001
111111111011000001110000000000001
100000000011000001110111111111111
11110111111111111100000010001
11110111111111   101010000001
11000000110101111100000010001
10000000000000001100000010001
10000000000000001101010010001
11000001110101011111011110N0111
11110111 1110100101111010001
11111111 1111111 111111111111
