NO ./textures/Wall/brick.xpm
SO ./textures/Wall/metal.xpm
WE ./textures/Wall/brick.xpm
EA ./textures/Wall/wood.xpm

F 255,100,0
C 225,255,255

11111111111111111111111111111111111111111111111111111111111111111111111111111111
10000000000000000001100001000000000000011000000000000000000110000000000000000001
10000000000000000000000000000000000000000000000000000000000000000000000000000001
100000000W0000000001100000111100000000001000000000000000000110000000000000000001
100000000000000000011000001  10000000110000000000000000001100000000000000000011
10000000000000000001100000111100000000011000000000000000000110000000000000000001
11111111111111111111111111111111111111111111111111111111111111111111111111111111
 