NO ./textures/Wall/brick.xpm
SO ./textures/Wall/metal.xpm
WE ./textures/Wall/wood.xpm
EA ./textures/Wall/wood.xpm










F 255,100,0
C 225,255,255




11111111111111111111
10000000000000000001
10000000000000000001
100000000W0000000001
10000000000000000001
10000000000000000001
11111111111111111111











